"","date","which.news","actual","forcast","difference"
"1","2016-01-13-10-30","US DOE Distillate Inventories",6136,"1550",4586
"2","2016-01-06-10-30","US DOE Distillate Inventories",6308,"2000",4308
"3","2015-12-30-10-30","US DOE Distillate Inventories",1795,"500",1295
"4","2015-12-23-10-30","US DOE Distillate Inventories",-661,"2000",-2661
"5","2015-12-16-10-30","US DOE Distillate Inventories",2563,"2000",563
"6","2015-12-09-10-30","US DOE Distillate Inventories",4998,"2250",2748
"7","2015-12-02-10-30","US DOE Distillate Inventories",3051,"500",2551
"8","2015-11-25-10-30","US DOE Distillate Inventories",1046,"-750",1796
"9","2015-11-18-10-30","US DOE Distillate Inventories",-791,"-500",-291
"10","2015-11-12-11-00","US DOE Distillate Inventories",352,"-1000",1352
"11","2015-11-04-10-30","US DOE Distillate Inventories",-1300,"-2000",700
"12","2015-10-28-10-30","US DOE Distillate Inventories",-2951,"-1750",-1201
"13","2015-10-21-10-30","US DOE Distillate Inventories",-2622,"-1100",-1522
"14","2015-10-15-11-00","US DOE Distillate Inventories",-1520,"-700",-820
"15","2015-10-07-10-30","US DOE Distillate Inventories",-2458,"-300",-2158
"16","2015-09-30-10-30","US DOE Distillate Inventories",-267,"-800",533
"17","2015-09-23-10-30","US DOE Distillate Inventories",-2088,"950",-3038
"18","2015-09-16-10-30","US DOE Distillate Inventories",3060,"300",2760
"19","2015-09-10-11-00","US DOE Distillate Inventories",952,"900",52
"20","2015-09-02-10-30","US DOE Distillate Inventories",115,"1000",-885
"21","2015-08-26-10-30","US DOE Distillate Inventories",1436,"1020",416
"22","2015-08-19-10-30","US DOE Distillate Inventories",594,"1500",-906
"23","2015-08-12-10-30","US DOE Distillate Inventories",2994,"1050",1944
"24","2015-08-05-10-30","US DOE Distillate Inventories",709,"1750",-1041
"25","2015-07-29-10-30","US DOE Distillate Inventories",2588,"1450",1138
"26","2015-07-22-10-30","US DOE Distillate Inventories",235,"1800",-1565
"27","2015-07-15-10-30","US DOE Distillate Inventories",3819,"1460",2359
"28","2015-07-08-10-30","US DOE Distillate Inventories",1641,"1000",641
"29","2015-07-01-10-30","US DOE Distillate Inventories",392,"1500",-1108
"30","2015-06-24-10-30","US DOE Distillate Inventories",1837,"700",1137
"31","2015-06-17-10-30","US DOE Distillate Inventories",114,"950",-836
"32","2015-06-10-10-30","US DOE Distillate Inventories",865,"700",165
"33","2015-06-03-10-30","US DOE Distillate Inventories",3773,"1300",2473
"34","2015-05-28-11-00","US DOE Distillate Inventories",1115,"-400",1515
"35","2015-05-20-10-30","US DOE Distillate Inventories",-546,"400",-946
"36","2015-05-13-10-30","US DOE Distillate Inventories",-2503,"750",-3253
"37","2015-05-06-10-30","US DOE Distillate Inventories",1503,"0",1503
"38","2015-04-29-10-30","US DOE Distillate Inventories",-66,"1000",-1066
"39","2015-04-22-10-30","US DOE Distillate Inventories",395,"1100",-705
"40","2015-04-15-10-30","US DOE Distillate Inventories",2017,"700",1317
"41","2015-04-08-10-30","US DOE Distillate Inventories",-250,"850",-1100
"42","2015-04-01-10-30","US DOE Distillate Inventories",1325,"0",1325
"43","2015-03-25-10-30","US DOE Distillate Inventories",-34,"-1000",966
"44","2015-03-18-10-30","US DOE Distillate Inventories",380,"-1500",1880
"45","2015-03-11-10-30","US DOE Distillate Inventories",2527,"-2250",4777
"46","2015-03-04-10-30","US DOE Distillate Inventories",-1722,"-2500",778
"47","2015-02-25-10-30","US DOE Distillate Inventories",-2711,"-3500",789
"48","2015-02-19-11-00","US DOE Distillate Inventories",-3814,"-2000",-1814
"49","2015-02-11-10-30","US DOE Distillate Inventories",-3252,"-1250",-2002
"50","2015-02-04-10-30","US DOE Distillate Inventories",1788,"-1500",3288
"51","2015-01-28-10-30","US DOE Distillate Inventories",-3892,"-1500",-2392
"52","2015-01-22-11-00","US DOE Distillate Inventories",-3272,"500",-3772
"53","2015-01-14-10-30","US DOE Distillate Inventories",2925,"2100",825
"54","2015-01-07-10-30","US DOE Distillate Inventories",11205,"1750",9455
"55","2014-12-31-10-30","US DOE Distillate Inventories",1874,"2000",-126
"56","2014-12-24-10-30","US DOE Distillate Inventories",2303,"-1000",3303
"57","2014-12-17-10-30","US DOE Distillate Inventories",-207,"150",-357
"58","2014-12-10-10-30","US DOE Distillate Inventories",5577,"1550",4027
"59","2014-12-03-10-30","US DOE Distillate Inventories",3028,"550",2478
"60","2014-11-26-10-30","US DOE Distillate Inventories",-1648,"-900",-748
"61","2014-11-19-10-30","US DOE Distillate Inventories",-2056,"-2000",-56
"62","2014-11-13-11-00","US DOE Distillate Inventories",-2803,"-1500",-1303
"63","2014-11-05-10-30","US DOE Distillate Inventories",-724,"-2200",1476
"64","2014-10-29-10-30","US DOE Distillate Inventories",-5294,"-1400",-3894
"65","2014-10-22-10-30","US DOE Distillate Inventories",1049,"-1300",2349
"66","2014-10-16-11-00","US DOE Distillate Inventories",-1518,"-1800",282
"67","2014-10-08-10-30","US DOE Distillate Inventories",439,"-1250",1689
"68","2014-10-01-10-30","US DOE Distillate Inventories",-2894,"0",-2894
"69","2014-09-24-10-30","US DOE Distillate Inventories",823,"500",323
"70","2014-09-17-10-30","US DOE Distillate Inventories",279,"750",-471
"71","2014-09-10-10-30","US DOE Distillate Inventories",4093,"1000",3093
"72","2014-09-04-11-00","US DOE Distillate Inventories",605,"-1000",1605
"73","2014-08-27-10-30","US DOE Distillate Inventories",1252,"0",1252
"74","2014-08-20-10-30","US DOE Distillate Inventories",-960,"-300",-660
"75","2014-08-13-10-30","US DOE Distillate Inventories",-2421,"-50",-2371
"76","2014-08-06-10-30","US DOE Distillate Inventories",-1798,"850",-2648
"77","2014-07-30-10-30","US DOE Distillate Inventories",789,"1500",-711
"78","2014-07-23-10-30","US DOE Distillate Inventories",1636,"2000",-364
"79","2014-07-16-10-30","US DOE Distillate Inventories",2528,"2000",528
"80","2014-07-09-10-30","US DOE Distillate Inventories",227,"1400",-1173
"81","2014-07-02-10-30","US DOE Distillate Inventories",975,"950",25
"82","2014-06-25-10-30","US DOE Distillate Inventories",1177,"850",327
"83","2014-06-18-10-30","US DOE Distillate Inventories",436,"350",86
"84","2014-06-11-10-30","US DOE Distillate Inventories",860,"1000",-140
"85","2014-06-04-10-30","US DOE Distillate Inventories",2012,"900",1112
"86","2014-05-29-11-00","US DOE Distillate Inventories",-196,"500",-696
"87","2014-05-21-10-30","US DOE Distillate Inventories",3399,"-500",3899
"88","2014-05-14-10-30","US DOE Distillate Inventories",-1124,"500",-1624
"89","2014-05-07-10-30","US DOE Distillate Inventories",-447,"750",-1197
"90","2014-04-30-10-30","US DOE Distillate Inventories",1936,"500",1436
"91","2014-04-23-10-30","US DOE Distillate Inventories",597,"-300",897
"92","2014-04-16-10-30","US DOE Distillate Inventories",-1278,"0",-1278
"93","2014-04-09-10-30","US DOE Distillate Inventories",239,"-250",489
"94","2014-04-02-10-30","US DOE Distillate Inventories",554,"0",554
"95","2014-03-26-10-30","US DOE Distillate Inventories",1555,"-1380",2935
"96","2014-03-19-10-30","US DOE Distillate Inventories",-3097,"-800",-2297
"97","2014-03-12-10-30","US DOE Distillate Inventories",-533,"-450",-83
"98","2014-03-05-10-30","US DOE Distillate Inventories",1414,"-1000",2414
"99","2014-02-26-10-30","US DOE Distillate Inventories",338,"-1250",1588
"100","2014-02-20-11-00","US DOE Distillate Inventories",-339,"-2100",1761
"101","2014-02-12-10-30","US DOE Distillate Inventories",-731,"-2125",1394
"102","2014-02-05-10-30","US DOE Distillate Inventories",-2360,"-2500",140
"103","2014-01-29-10-30","US DOE Distillate Inventories",-4584,"-2550",-2034
"104","2014-01-23-11-00","US DOE Distillate Inventories",-3212,"-500",-2712
"105","2014-01-15-10-30","US DOE Distillate Inventories",-1023,"1250",-2273
"106","2014-01-08-10-30","US DOE Distillate Inventories",5826,"2250",3576
"107","2014-01-03-11-00","US DOE Distillate Inventories",5042,"750",4292
"108","2013-12-27-11-00","US DOE Distillate Inventories",-1850,"-1000",-850
"109","2013-12-18-10-30","US DOE Distillate Inventories",-2110,"0",-2110
"110","2013-12-11-10-30","US DOE Distillate Inventories",4541,"1550",2991
"111","2013-12-04-10-30","US DOE Distillate Inventories",2649,"-1500",4149
"112","2013-11-27-10-30","US DOE Distillate Inventories",-1666,"-1000",-666
"113","2013-11-20-10-30","US DOE Distillate Inventories",-4795,"-280",-4515
"114","2013-11-14-11-00","US DOE Distillate Inventories",-481,"-1000",519
"115","2013-11-06-10-30","US DOE Distillate Inventories",-4899,"-1500",-3399
"116","2013-10-30-10-30","US DOE Distillate Inventories",-3058,"-1000",-2058
"117","2013-10-23-10-30","US DOE Distillate Inventories",1537,"-1800",3337
"118","2013-10-21-10-30","US DOE Distillate Inventories",1537,"-1800",3337
"119","2013-10-09-10-30","US DOE Distillate Inventories",-3141,"-1150",-1991
"120","2013-10-02-10-30","US DOE Distillate Inventories",-1680,"-1000",-680
"121","2013-09-25-10-30","US DOE Distillate Inventories",-234,"-925",691
"122","2013-09-18-10-30","US DOE Distillate Inventories",-1079,"500",-1579
"123","2013-09-11-10-30","US DOE Distillate Inventories",2586,"600",1986
"124","2013-09-05-11-00","US DOE Distillate Inventories",549,"600",-51
"125","2013-08-28-10-30","US DOE Distillate Inventories",-316,"550",-866
"126","2013-08-21-10-30","US DOE Distillate Inventories",871,"1000",-129
"127","2013-08-14-10-30","US DOE Distillate Inventories",2027,"1000",1027
"128","2013-08-07-10-30","US DOE Distillate Inventories",469,"0",469
"129","2013-07-31-10-30","US DOE Distillate Inventories",-466,"450",-916
"130","2013-07-24-10-30","US DOE Distillate Inventories",-1227,"1850",-3077
"131","2013-07-17-10-30","US DOE Distillate Inventories",3870,"1500",2370
"132","2013-07-10-10-30","US DOE Distillate Inventories",3038,"1000",2038
"133","2013-07-03-10-30","US DOE Distillate Inventories",-2418,"1000",-3418
"134","2013-06-26-10-30","US DOE Distillate Inventories",1567,"650",917
"135","2013-06-19-10-30","US DOE Distillate Inventories",-489,"925",-1414
"136","2013-06-12-10-30","US DOE Distillate Inventories",-1163,"1500",-2663
"137","2013-06-05-10-30","US DOE Distillate Inventories",2611,"1400",1211
"138","2013-05-30-11-00","US DOE Distillate Inventories",1851,"-450",2301
"139","2013-05-22-10-30","US DOE Distillate Inventories",-1052,"1000",-2052
"140","2013-05-15-10-30","US DOE Distillate Inventories",2300,"475",1825
"141","2013-05-08-10-30","US DOE Distillate Inventories",1812,"500",1312
"142","2013-05-01-10-30","US DOE Distillate Inventories",474,"250",224
"143","2013-04-24-10-30","US DOE Distillate Inventories",97,"500",-403
"144","2013-04-17-10-30","US DOE Distillate Inventories",2364,"-350",2714
"145","2013-04-10-10-30","US DOE Distillate Inventories",-169,"-1500",1331
"146","2013-04-03-10-30","US DOE Distillate Inventories",-2266,"-1100",-1166
"147","2013-03-27-10-30","US DOE Distillate Inventories",-4513,"-850",-3663
"148","2013-03-20-10-30","US DOE Distillate Inventories",-672,"-1000",328
"149","2013-03-13-10-30","US DOE Distillate Inventories",83,"-2000",2083
"150","2013-03-06-10-30","US DOE Distillate Inventories",-3830,"-1000",-2830
"151","2013-02-27-10-30","US DOE Distillate Inventories",557,"-1550",2107
"152","2013-02-21-11-00","US DOE Distillate Inventories",-2277,"-1800",-477
"153","2013-02-13-10-30","US DOE Distillate Inventories",-3677,"-1750",-1927
"154","2013-02-06-10-30","US DOE Distillate Inventories",-1042,"-625",-417
"155","2013-01-30-10-30","US DOE Distillate Inventories",-2315,"-500",-1815
"156","2013-01-24-11-00","US DOE Distillate Inventories",508,"0",508
"157","2013-01-16-10-30","US DOE Distillate Inventories",1686,"1500",186
"158","2013-01-09-10-30","US DOE Distillate Inventories",6777,"1900",4877
"159","2013-01-04-11-00","US DOE Distillate Inventories",4574,"1250",3324
"160","2012-12-28-11-00","US DOE Distillate Inventories",2423,"-850",3273
"161","2012-12-19-10-30","US DOE Distillate Inventories",-1085,"1000",-2085
"162","2012-12-12-10-30","US DOE Distillate Inventories",2986,"1100",1886
"163","2012-12-05-10-30","US DOE Distillate Inventories",3027,"850",2177
"164","2012-11-28-10-30","US DOE Distillate Inventories",-800,"500",-1300
"165","2012-11-21-10-30","US DOE Distillate Inventories",-2675,"-1000",-1675
"166","2012-11-15-11-00","US DOE Distillate Inventories",-2539,"-950",-1589
"167","2012-11-07-10-30","US DOE Distillate Inventories",131,"-1250",1381
"168","2012-11-01-11-00","US DOE Distillate Inventories",-93,"-1400",1307
"169","2012-10-24-10-30","US DOE Distillate Inventories",-646,"-1200",554
"170","2012-10-17-10-30","US DOE Distillate Inventories",-2218,"-1500",-718
"171","2012-10-11-11-00","US DOE Distillate Inventories",-3177,"-1000",-2177
"172","2012-10-03-10-30","US DOE Distillate Inventories",-3689,"-400",-3289
"173","2012-09-26-10-30","US DOE Distillate Inventories",-482,"500",-982
"174","2012-09-19-10-30","US DOE Distillate Inventories",-322,"1000",-1322
"175","2012-09-12-10-30","US DOE Distillate Inventories",1476,"-500",1976
"176","2012-09-06-11-00","US DOE Distillate Inventories",993,"-1550",2543
"177","2012-08-29-10-30","US DOE Distillate Inventories",873,"200",673
"178","2012-08-22-10-30","US DOE Distillate Inventories",992,"1000",-8
"179","2012-08-15-10-30","US DOE Distillate Inventories",677,"-275",952
"180","2012-08-08-10-30","US DOE Distillate Inventories",-724,"250",-974
"181","2012-08-01-10-30","US DOE Distillate Inventories",-974,"1100",-2074
"182","2012-07-25-10-30","US DOE Distillate Inventories",1708,"1400",308
"183","2012-07-18-10-30","US DOE Distillate Inventories",2619,"1300",1319
"184","2012-07-11-10-30","US DOE Distillate Inventories",3112,"625",2487
"185","2012-07-05-11-00","US DOE Distillate Inventories",-1051,"1000",-2051
"186","2012-06-27-10-30","US DOE Distillate Inventories",-2279,"1225",-3504
"187","2012-06-20-10-30","US DOE Distillate Inventories",1156,"1000",156
"188","2012-06-13-10-30","US DOE Distillate Inventories",-63,"1175",-1238
"189","2012-06-06-10-30","US DOE Distillate Inventories",2253,"-250",2503
"190","2012-05-31-11-00","US DOE Distillate Inventories",-1709,"0",-1709
"191","2012-05-23-10-30","US DOE Distillate Inventories",-309,"-500",191
"192","2012-05-16-10-30","US DOE Distillate Inventories",-969,"150",-1119
"193","2012-05-09-10-30","US DOE Distillate Inventories",-3251,"125",-3376
"194","2012-05-02-10-30","US DOE Distillate Inventories",-1903,"-350",-1553
"195","2012-04-25-10-30","US DOE Distillate Inventories",-3052,"500",-3552
"196","2012-04-18-10-30","US DOE Distillate Inventories",-2908,"-125",-2783
"197","2012-04-11-10-30","US DOE Distillate Inventories",-4000,"-250",-3750
"198","2012-04-04-10-30","US DOE Distillate Inventories",19,"-500",519
"199","2012-03-28-10-30","US DOE Distillate Inventories",-711,"-500",-211
"200","2012-03-21-10-30","US DOE Distillate Inventories",1763,"-1500",3263
"201","2012-03-14-10-30","US DOE Distillate Inventories",-4682,"-1500",-3182
"202","2012-03-07-10-30","US DOE Distillate Inventories",-1944,"-1650",-294
"203","2012-02-29-10-30","US DOE Distillate Inventories",-2069,"-750",-1319
"204","2012-02-23-11-00","US DOE Distillate Inventories",-208,"-1500",1292
"205","2012-02-15-10-30","US DOE Distillate Inventories",-2867,"-1100",-1767
"206","2012-02-08-10-30","US DOE Distillate Inventories",1174,"-875",2049
"207","2012-02-01-10-30","US DOE Distillate Inventories",-135,"-1375",1240
"208","2012-01-25-10-30","US DOE Distillate Inventories",-2456,"-125",-2331
"209","2012-01-19-11-00","US DOE Distillate Inventories",438,"1375",-937
"210","2012-01-11-10-30","US DOE Distillate Inventories",3985,"2250",1735
"211","2012-01-05-11-00","US DOE Distillate Inventories",3224,"1000",2224
"212","2011-12-29-11-00","US DOE Distillate Inventories",1205,"-650",1855
