"","date","which.news","actual","forcast","difference"
"1","2016-01-13-10-30","US DOE Gasoline Inventories",8438,"2700",5738
"2","2016-01-06-10-30","US DOE Gasoline Inventories",10576,"1800",8776
"3","2015-12-30-10-30","US DOE Gasoline Inventories",925,"500",425
"4","2015-12-23-10-30","US DOE Gasoline Inventories",1111,"1300",-189
"5","2015-12-16-10-30","US DOE Gasoline Inventories",1731,"1000",731
"6","2015-12-09-10-30","US DOE Gasoline Inventories",786,"1750",-964
"7","2015-12-02-10-30","US DOE Gasoline Inventories",135,"1550",-1415
"8","2015-11-25-10-30","US DOE Gasoline Inventories",2478,"950",1528
"9","2015-11-18-10-30","US DOE Gasoline Inventories",1009,"-500",1509
"10","2015-11-12-11-00","US DOE Gasoline Inventories",-2102,"-1000",-1102
"11","2015-11-04-10-30","US DOE Gasoline Inventories",-3300,"-1250",-2050
"12","2015-10-28-10-30","US DOE Gasoline Inventories",-1137,"-1050",-87
"13","2015-10-21-10-30","US DOE Gasoline Inventories",-1518,"-1000",-518
"14","2015-10-15-11-00","US DOE Gasoline Inventories",-2618,"-1250",-1368
"15","2015-10-07-10-30","US DOE Gasoline Inventories",1910,"250",1660
"16","2015-09-30-10-30","US DOE Gasoline Inventories",3254,"-500",3754
"17","2015-09-23-10-30","US DOE Gasoline Inventories",1369,"850",519
"18","2015-09-16-10-30","US DOE Gasoline Inventories",2840,"-500",3340
"19","2015-09-10-11-00","US DOE Gasoline Inventories",384,"-150",534
"20","2015-09-02-10-30","US DOE Gasoline Inventories",-271,"-2000",1729
"21","2015-08-26-10-30","US DOE Gasoline Inventories",1660,"-950",2610
"22","2015-08-19-10-30","US DOE Gasoline Inventories",-2708,"-1250",-1458
"23","2015-08-12-10-30","US DOE Gasoline Inventories",-1251,"-675",-576
"24","2015-08-05-10-30","US DOE Gasoline Inventories",811,"-200",1011
"25","2015-07-29-10-30","US DOE Gasoline Inventories",-363,"250",-613
"26","2015-07-22-10-30","US DOE Gasoline Inventories",-1725,"300",-2025
"27","2015-07-15-10-30","US DOE Gasoline Inventories",58,"450",-392
"28","2015-07-08-10-30","US DOE Gasoline Inventories",1215,"0",1215
"29","2015-07-01-10-30","US DOE Gasoline Inventories",-1757,"-250",-1507
"30","2015-06-24-10-30","US DOE Gasoline Inventories",680,"0",680
"31","2015-06-17-10-30","US DOE Gasoline Inventories",460,"-800",1260
"32","2015-06-10-10-30","US DOE Gasoline Inventories",-2939,"-400",-2539
"33","2015-06-03-10-30","US DOE Gasoline Inventories",-334,"500",-834
"34","2015-05-28-11-00","US DOE Gasoline Inventories",-3309,"-1300",-2009
"35","2015-05-20-10-30","US DOE Gasoline Inventories",-2774,"650",-3424
"36","2015-05-13-10-30","US DOE Gasoline Inventories",-1142,"250",-1392
"37","2015-05-06-10-30","US DOE Gasoline Inventories",401,"1000",-599
"38","2015-04-29-10-30","US DOE Gasoline Inventories",1713,"900",813
"39","2015-04-22-10-30","US DOE Gasoline Inventories",-2135,"-1000",-1135
"40","2015-04-15-10-30","US DOE Gasoline Inventories",-2072,"-750",-1322
"41","2015-04-08-10-30","US DOE Gasoline Inventories",817,"-2000",2817
"42","2015-04-01-10-30","US DOE Gasoline Inventories",-4258,"-650",-3608
"43","2015-03-25-10-30","US DOE Gasoline Inventories",-2014,"-2300",286
"44","2015-03-18-10-30","US DOE Gasoline Inventories",-4473,"-900",-3573
"45","2015-03-11-10-30","US DOE Gasoline Inventories",-187,"-1750",1563
"46","2015-03-04-10-30","US DOE Gasoline Inventories",46,"-2000",2046
"47","2015-02-25-10-30","US DOE Gasoline Inventories",-3118,"-2000",-1118
"48","2015-02-19-11-00","US DOE Gasoline Inventories",485,"-650",1135
"49","2015-02-11-10-30","US DOE Gasoline Inventories",1977,"200",1777
"50","2015-02-04-10-30","US DOE Gasoline Inventories",2335,"-1150",3485
"51","2015-01-28-10-30","US DOE Gasoline Inventories",-2587,"500",-3087
"52","2015-01-22-11-00","US DOE Gasoline Inventories",588,"1500",-912
"53","2015-01-14-10-30","US DOE Gasoline Inventories",3171,"3750",-579
"54","2015-01-07-10-30","US DOE Gasoline Inventories",8115,"4500",3615
"55","2014-12-31-10-30","US DOE Gasoline Inventories",2951,"2000",951
"56","2014-12-24-10-30","US DOE Gasoline Inventories",4083,"1000",3083
"57","2014-12-17-10-30","US DOE Gasoline Inventories",5250,"1750",3500
"58","2014-12-10-10-30","US DOE Gasoline Inventories",8197,"2550",5647
"59","2014-12-03-10-30","US DOE Gasoline Inventories",2143,"1500",643
"60","2014-11-26-10-30","US DOE Gasoline Inventories",1825,"1500",325
"61","2014-11-19-10-30","US DOE Gasoline Inventories",1034,"900",134
"62","2014-11-13-11-00","US DOE Gasoline Inventories",1805,"200",1605
"63","2014-11-05-10-30","US DOE Gasoline Inventories",-1378,"-600",-778
"64","2014-10-29-10-30","US DOE Gasoline Inventories",-1236,"-900",-336
"65","2014-10-22-10-30","US DOE Gasoline Inventories",-1299,"-1450",151
"66","2014-10-16-11-00","US DOE Gasoline Inventories",-3995,"-1700",-2295
"67","2014-10-08-10-30","US DOE Gasoline Inventories",1180,"-500",1680
"68","2014-10-01-10-30","US DOE Gasoline Inventories",-1836,"-600",-1236
"69","2014-09-24-10-30","US DOE Gasoline Inventories",-414,"0",-414
"70","2014-09-17-10-30","US DOE Gasoline Inventories",-1635,"-125",-1510
"71","2014-09-10-10-30","US DOE Gasoline Inventories",2381,"0",2381
"72","2014-09-04-11-00","US DOE Gasoline Inventories",-2322,"-1400",-922
"73","2014-08-27-10-30","US DOE Gasoline Inventories",-960,"-1600",640
"74","2014-08-20-10-30","US DOE Gasoline Inventories",585,"-1550",2135
"75","2014-08-13-10-30","US DOE Gasoline Inventories",-1160,"-1500",340
"76","2014-08-06-10-30","US DOE Gasoline Inventories",-4387,"0",-4387
"77","2014-07-30-10-30","US DOE Gasoline Inventories",365,"1000",-635
"78","2014-07-23-10-30","US DOE Gasoline Inventories",3379,"1000",2379
"79","2014-07-16-10-30","US DOE Gasoline Inventories",171,"950",-779
"80","2014-07-09-10-30","US DOE Gasoline Inventories",579,"-400",979
"81","2014-07-02-10-30","US DOE Gasoline Inventories",-1235,"550",-1785
"82","2014-06-25-10-30","US DOE Gasoline Inventories",710,"1450",-740
"83","2014-06-18-10-30","US DOE Gasoline Inventories",785,"-550",1335
"84","2014-06-11-10-30","US DOE Gasoline Inventories",1697,"1000",697
"85","2014-06-04-10-30","US DOE Gasoline Inventories",210,"400",-190
"86","2014-05-29-11-00","US DOE Gasoline Inventories",-1803,"0",-1803
"87","2014-05-21-10-30","US DOE Gasoline Inventories",970,"0",970
"88","2014-05-14-10-30","US DOE Gasoline Inventories",-772,"300",-1072
"89","2014-05-07-10-30","US DOE Gasoline Inventories",1608,"500",1108
"90","2014-04-30-10-30","US DOE Gasoline Inventories",1564,"-900",2464
"91","2014-04-23-10-30","US DOE Gasoline Inventories",-274,"-1650",1376
"92","2014-04-16-10-30","US DOE Gasoline Inventories",-154,"-1750",1596
"93","2014-04-09-10-30","US DOE Gasoline Inventories",-5188,"-1000",-4188
"94","2014-04-02-10-30","US DOE Gasoline Inventories",-1574,"-2000",426
"95","2014-03-26-10-30","US DOE Gasoline Inventories",-5101,"-1500",-3601
"96","2014-03-19-10-30","US DOE Gasoline Inventories",-1467,"-1550",83
"97","2014-03-12-10-30","US DOE Gasoline Inventories",-5230,"-2000",-3230
"98","2014-03-05-10-30","US DOE Gasoline Inventories",-1604,"-1000",-604
"99","2014-02-26-10-30","US DOE Gasoline Inventories",-2807,"-1000",-1807
"100","2014-02-20-11-00","US DOE Gasoline Inventories",309,"-850",1159
"101","2014-02-12-10-30","US DOE Gasoline Inventories",-1853,"100",-1953
"102","2014-02-05-10-30","US DOE Gasoline Inventories",505,"1150",-645
"103","2014-01-29-10-30","US DOE Gasoline Inventories",-819,"1600",-2419
"104","2014-01-23-11-00","US DOE Gasoline Inventories",2123,"1750",373
"105","2014-01-15-10-30","US DOE Gasoline Inventories",6183,"2500",3683
"106","2014-01-08-10-30","US DOE Gasoline Inventories",6243,"2500",3743
"107","2014-01-03-11-00","US DOE Gasoline Inventories",844,"1375",-531
"108","2013-12-27-11-00","US DOE Gasoline Inventories",-614,"1100",-1714
"109","2013-12-18-10-30","US DOE Gasoline Inventories",1337,"1500",-163
"110","2013-12-11-10-30","US DOE Gasoline Inventories",6717,"2000",4717
"111","2013-12-04-10-30","US DOE Gasoline Inventories",1828,"1250",578
"112","2013-11-27-10-30","US DOE Gasoline Inventories",1751,"500",1251
"113","2013-11-20-10-30","US DOE Gasoline Inventories",-345,"-300",-45
"114","2013-11-14-11-00","US DOE Gasoline Inventories",-838,"-900",62
"115","2013-11-06-10-30","US DOE Gasoline Inventories",-3755,"-400",-3355
"116","2013-10-30-10-30","US DOE Gasoline Inventories",-1713,"-200",-1513
"117","2013-10-23-10-30","US DOE Gasoline Inventories",-1805,"-1000",-805
"118","2013-10-21-10-30","US DOE Gasoline Inventories",-1805,"-1000",-805
"119","2013-10-09-10-30","US DOE Gasoline Inventories",149,"1050",-901
"120","2013-10-02-10-30","US DOE Gasoline Inventories",3495,"-700",4195
"121","2013-09-25-10-30","US DOE Gasoline Inventories",217,"-750",967
"122","2013-09-18-10-30","US DOE Gasoline Inventories",-1627,"500",-2127
"123","2013-09-11-10-30","US DOE Gasoline Inventories",1658,"-1000",2658
"124","2013-09-05-11-00","US DOE Gasoline Inventories",-1827,"-700",-1127
"125","2013-08-28-10-30","US DOE Gasoline Inventories",-587,"-1375",788
"126","2013-08-21-10-30","US DOE Gasoline Inventories",-4029,"-1500",-2529
"127","2013-08-14-10-30","US DOE Gasoline Inventories",-1169,"-1600",431
"128","2013-08-07-10-30","US DOE Gasoline Inventories",135,"-500",635
"129","2013-07-31-10-30","US DOE Gasoline Inventories",770,"-1500",2270
"130","2013-07-24-10-30","US DOE Gasoline Inventories",-1389,"1650",-3039
"131","2013-07-17-10-30","US DOE Gasoline Inventories",3055,"-1500",4555
"132","2013-07-10-10-30","US DOE Gasoline Inventories",-2634,"1000",-3634
"133","2013-07-03-10-30","US DOE Gasoline Inventories",-1719,"700",-2419
"134","2013-06-26-10-30","US DOE Gasoline Inventories",3653,"875",2778
"135","2013-06-19-10-30","US DOE Gasoline Inventories",183,"750",-567
"136","2013-06-12-10-30","US DOE Gasoline Inventories",2748,"500",2248
"137","2013-06-05-10-30","US DOE Gasoline Inventories",-366,"1000",-1366
"138","2013-05-30-11-00","US DOE Gasoline Inventories",-1514,"-500",-1014
"139","2013-05-22-10-30","US DOE Gasoline Inventories",3015,"-300",3315
"140","2013-05-15-10-30","US DOE Gasoline Inventories",2588,"-1100",3688
"141","2013-05-08-10-30","US DOE Gasoline Inventories",-910,"-475",-435
"142","2013-05-01-10-30","US DOE Gasoline Inventories",-1818,"-900",-918
"143","2013-04-24-10-30","US DOE Gasoline Inventories",-3928,"-600",-3328
"144","2013-04-17-10-30","US DOE Gasoline Inventories",-633,"-800",167
"145","2013-04-10-10-30","US DOE Gasoline Inventories",1699,"-1500",3199
"146","2013-04-03-10-30","US DOE Gasoline Inventories",-572,"-1000",428
"147","2013-03-27-10-30","US DOE Gasoline Inventories",-1596,"-1000",-596
"148","2013-03-20-10-30","US DOE Gasoline Inventories",-1476,"-2000",524
"149","2013-03-13-10-30","US DOE Gasoline Inventories",-3571,"-1200",-2371
"150","2013-03-06-10-30","US DOE Gasoline Inventories",-616,"-1000",384
"151","2013-02-27-10-30","US DOE Gasoline Inventories",-1857,"-1000",-857
"152","2013-02-21-11-00","US DOE Gasoline Inventories",-2884,"-900",-1984
"153","2013-02-13-10-30","US DOE Gasoline Inventories",-803,"500",-1303
"154","2013-02-06-10-30","US DOE Gasoline Inventories",1738,"900",838
"155","2013-01-30-10-30","US DOE Gasoline Inventories",-956,"1000",-1956
"156","2013-01-24-11-00","US DOE Gasoline Inventories",-1738,"1250",-2988
"157","2013-01-16-10-30","US DOE Gasoline Inventories",1910,"2700",-790
"158","2013-01-09-10-30","US DOE Gasoline Inventories",7412,"2500",4912
"159","2013-01-04-11-00","US DOE Gasoline Inventories",2569,"2200",369
"160","2012-12-28-11-00","US DOE Gasoline Inventories",3782,"850",2932
"161","2012-12-19-10-30","US DOE Gasoline Inventories",2207,"2000",207
"162","2012-12-12-10-30","US DOE Gasoline Inventories",5000,"2000",3000
"163","2012-12-05-10-30","US DOE Gasoline Inventories",7860,"1550",6310
"164","2012-11-28-10-30","US DOE Gasoline Inventories",3865,"900",2965
"165","2012-11-21-10-30","US DOE Gasoline Inventories",-1547,"1000",-2547
"166","2012-11-15-11-00","US DOE Gasoline Inventories",-440,"-1000",560
"167","2012-11-07-10-30","US DOE Gasoline Inventories",2875,"-1500",4375
"168","2012-11-01-11-00","US DOE Gasoline Inventories",935,"850",85
"169","2012-10-24-10-30","US DOE Gasoline Inventories",1439,"500",939
"170","2012-10-17-10-30","US DOE Gasoline Inventories",1720,"500",1220
"171","2012-10-11-11-00","US DOE Gasoline Inventories",-534,"250",-784
"172","2012-10-03-10-30","US DOE Gasoline Inventories",114,"-500",614
"173","2012-09-26-10-30","US DOE Gasoline Inventories",-481,"500",-981
"174","2012-09-19-10-30","US DOE Gasoline Inventories",-1407,"1000",-2407
"175","2012-09-12-10-30","US DOE Gasoline Inventories",-1177,"-1700",523
"176","2012-09-06-11-00","US DOE Gasoline Inventories",-2334,"-3000",666
"177","2012-08-29-10-30","US DOE Gasoline Inventories",-1509,"-1450",-59
"178","2012-08-22-10-30","US DOE Gasoline Inventories",-962,"-1350",388
"179","2012-08-15-10-30","US DOE Gasoline Inventories",-2371,"-2000",-371
"180","2012-08-08-10-30","US DOE Gasoline Inventories",-1801,"-1750",-51
"181","2012-08-01-10-30","US DOE Gasoline Inventories",-2174,"800",-2974
"182","2012-07-25-10-30","US DOE Gasoline Inventories",4134,"-1000",5134
"183","2012-07-18-10-30","US DOE Gasoline Inventories",-1815,"1200",-3015
"184","2012-07-11-10-30","US DOE Gasoline Inventories",2752,"500",2252
"185","2012-07-05-11-00","US DOE Gasoline Inventories",151,"1000",-849
"186","2012-06-27-10-30","US DOE Gasoline Inventories",2078,"1000",1078
"187","2012-06-20-10-30","US DOE Gasoline Inventories",943,"1000",-57
"188","2012-06-13-10-30","US DOE Gasoline Inventories",-1724,"1400",-3124
"189","2012-06-06-10-30","US DOE Gasoline Inventories",3346,"950",2396
"190","2012-05-31-11-00","US DOE Gasoline Inventories",-833,"-1000",167
"191","2012-05-23-10-30","US DOE Gasoline Inventories",-3299,"-650",-2649
"192","2012-05-16-10-30","US DOE Gasoline Inventories",-2797,"-100",-2697
"193","2012-05-09-10-30","US DOE Gasoline Inventories",-2613,"-750",-1863
"194","2012-05-02-10-30","US DOE Gasoline Inventories",-2009,"-1500",-509
"195","2012-04-25-10-30","US DOE Gasoline Inventories",-2235,"-1500",-735
"196","2012-04-18-10-30","US DOE Gasoline Inventories",-3671,"-1100",-2571
"197","2012-04-11-10-30","US DOE Gasoline Inventories",-4277,"-1375",-2902
"198","2012-04-04-10-30","US DOE Gasoline Inventories",-1457,"-1400",-57
"199","2012-03-28-10-30","US DOE Gasoline Inventories",-3537,"-1550",-1987
"200","2012-03-21-10-30","US DOE Gasoline Inventories",-1214,"-2000",786
"201","2012-03-14-10-30","US DOE Gasoline Inventories",-1410,"-1000",-410
"202","2012-03-07-10-30","US DOE Gasoline Inventories",-396,"-1600",1204
"203","2012-02-29-10-30","US DOE Gasoline Inventories",-1600,"-425",-1175
"204","2012-02-23-11-00","US DOE Gasoline Inventories",-649,"250",-899
"205","2012-02-15-10-30","US DOE Gasoline Inventories",400,"700",-300
"206","2012-02-08-10-30","US DOE Gasoline Inventories",1629,"875",754
"207","2012-02-01-10-30","US DOE Gasoline Inventories",3017,"500",2517
"208","2012-01-25-10-30","US DOE Gasoline Inventories",-390,"2000",-2390
"209","2012-01-19-11-00","US DOE Gasoline Inventories",3717,"2350",1367
"210","2012-01-11-10-30","US DOE Gasoline Inventories",3610,"2550",1060
"211","2012-01-05-11-00","US DOE Gasoline Inventories",2479,"1000",1479
"212","2011-12-29-11-00","US DOE Gasoline Inventories",-692,"-500",-192
